45,45,45,45,45,45,45,45,45,45,45,45,45,45,45,45,45,45,45,45,45,45,45,45,45,45,45,45,45,0
45,45,45,0,0,0,0,0,0,0,0,0,0,0,0,0,0,0,0,0,0,0,0,0,0,0,88,89,45,0
45,45,0,0,0,0,0,0,0,0,0,0,0,0,0,0,0,0,0,0,0,0,0,0,0,0,102,103,45,0
45,0,0,0,0,0,0,0,0,0,0,0,0,0,0,0,0,0,0,0,0,0,0,0,0,0,45,45,45,0
45,0,0,0,0,0,0,0,0,0,0,0,0,0,0,0,0,0,0,0,0,0,0,0,0,0,45,45,45,0
45,0,0,0,0,0,0,0,0,0,0,45,45,45,45,45,45,45,45,45,45,45,45,45,45,45,45,45,45,0
45,0,0,0,0,0,0,0,0,0,45,45,45,45,45,45,45,45,45,45,45,45,45,45,45,45,45,45,45,0
45,0,0,0,0,0,0,0,0,45,45,45,45,45,45,45,45,45,45,45,45,45,45,45,45,45,45,45,45,0
45,0,0,0,0,0,0,0,0,45,45,45,45,45,45,45,45,0,0,0,0,0,0,0,0,0,45,45,45,0
45,0,0,0,0,0,0,0,0,45,45,45,45,45,45,45,45,0,0,0,0,0,0,0,0,0,45,45,45,0
45,0,0,0,0,0,0,0,0,45,45,45,45,45,45,45,45,0,0,45,0,0,0,90,91,0,45,45,45,0
45,0,0,0,0,0,0,0,0,45,45,45,45,45,45,45,45,0,0,0,0,0,0,104,105,0,45,45,45,0
45,0,0,0,0,0,0,0,0,45,45,45,45,45,45,45,45,107,107,107,107,107,107,107,107,107,107,45,45,0
45,0,0,0,0,0,0,0,0,45,45,45,45,45,45,45,45,45,45,45,45,45,45,45,45,45,45,45,45,0
45,0,0,0,0,0,0,0,0,45,45,45,45,45,45,45,45,45,45,45,45,45,45,45,45,45,45,45,0,0
45,0,0,0,0,0,0,0,0,0,0,0,0,0,0,0,0,0,0,0,0,0,0,0,0,0,0,45,0,0
45,0,0,0,0,0,0,0,0,0,0,0,0,0,0,0,0,0,0,0,0,0,0,0,0,0,0,45,0,0
45,45,0,0,0,0,0,0,0,0,0,0,0,0,0,0,0,0,0,0,0,0,0,0,0,0,0,45,0,0
45,45,45,0,0,0,0,0,0,0,0,0,0,0,0,0,0,0,0,0,0,0,0,0,0,0,0,45,0,0
45,45,45,45,0,0,0,0,0,0,0,0,0,0,0,0,0,0,0,0,0,0,0,0,0,0,0,45,0,0
45,45,45,45,0,0,0,0,0,0,0,0,0,0,0,0,0,0,0,0,0,0,0,0,0,0,0,45,0,0
45,45,45,45,45,45,45,45,45,45,45,45,45,45,45,45,45,45,45,0,0,0,0,0,0,0,0,45,0,0
45,45,45,45,45,0,0,0,0,0,0,0,0,0,0,0,0,0,0,0,0,0,0,0,0,0,0,45,0,0
45,45,45,45,45,0,0,0,0,0,0,0,0,0,0,0,0,0,0,0,0,0,0,0,0,0,0,45,0,0
45,45,45,45,45,0,0,0,0,0,0,0,0,0,0,0,0,0,0,0,0,0,0,0,0,0,0,45,0,0
45,45,45,45,45,0,0,0,0,0,0,0,0,0,0,0,0,0,0,0,0,0,0,0,0,0,0,45,0,0
45,45,45,45,45,0,0,0,0,0,0,0,0,0,0,0,0,0,0,0,0,0,0,0,0,0,0,45,0,0
45,45,45,45,45,45,0,0,0,0,0,0,0,0,0,0,0,0,0,0,0,45,45,45,45,45,45,45,0,0
45,45,45,45,45,45,45,0,0,0,0,0,0,0,0,0,0,0,0,0,45,45,45,45,45,45,45,45,0,0
45,45,45,45,45,45,45,45,0,0,0,0,0,0,0,0,0,0,0,45,45,45,45,45,45,45,45,45,0,0
45,45,45,45,45,45,45,45,45,0,0,0,0,0,0,0,0,0,45,45,45,45,45,45,45,45,45,45,0,0
45,45,45,45,45,45,45,45,45,45,0,0,0,0,0,0,0,0,45,45,45,45,45,45,45,45,45,45,0,0
45,45,45,45,45,45,45,45,45,45,0,0,0,0,0,0,0,0,45,45,45,45,45,45,45,45,45,45,0,0
45,45,45,45,45,45,45,45,45,45,0,0,0,0,0,0,0,0,45,45,45,45,45,45,45,45,45,45,0,0
45,45,45,45,45,45,45,45,45,45,0,0,0,0,0,0,0,0,45,45,45,45,45,45,45,45,45,45,0,0
45,45,45,45,45,45,45,45,45,45,0,0,0,0,0,0,0,0,45,45,45,45,45,45,45,45,45,45,0,0
45,45,45,45,45,45,45,45,45,45,0,0,0,0,0,0,0,0,45,45,45,45,45,45,45,45,45,45,0,0
45,45,45,45,45,45,45,45,45,45,0,0,0,0,0,0,0,0,45,45,45,45,45,45,45,45,45,45,0,0
45,45,45,45,45,45,45,45,45,45,0,0,0,0,0,0,0,0,45,45,45,45,45,45,45,45,45,45,0,0
45,45,45,45,45,45,45,45,45,45,0,0,0,0,0,0,0,0,45,45,45,45,45,45,45,45,45,45,0,0
45,45,45,45,45,45,45,45,45,45,0,0,0,0,0,0,0,0,45,45,45,45,45,45,45,45,45,45,0,0
45,45,45,45,45,45,45,45,45,45,0,0,38,0,0,38,0,0,45,45,45,45,45,45,45,45,45,45,0,0
45,45,45,45,45,45,45,45,45,45,0,0,0,0,0,0,0,0,45,45,45,45,45,45,45,45,45,45,0,0
45,45,45,45,45,45,45,45,45,45,0,0,38,0,0,38,0,0,45,45,45,45,45,45,45,45,45,45,0,0
45,45,45,45,45,45,45,45,45,45,0,0,0,0,0,0,0,0,45,45,45,45,45,45,45,45,45,45,0,0
45,45,45,45,45,45,45,45,45,45,0,0,38,0,0,38,0,0,45,45,45,45,45,45,45,45,45,45,0,0
45,45,45,45,45,45,45,45,45,45,0,0,0,0,0,0,0,0,45,45,45,45,45,45,45,45,45,45,0,0
45,45,45,45,45,45,45,45,45,45,0,0,38,0,0,38,0,0,45,45,45,45,45,45,45,45,45,45,0,0
45,45,45,45,45,45,45,45,45,45,0,0,0,0,0,0,0,0,45,45,45,45,45,45,45,45,45,45,0,0
45,45,45,45,45,45,45,45,45,45,0,0,38,0,0,38,0,0,45,45,45,45,45,45,45,45,45,45,0,0
45,45,45,45,45,45,45,45,45,45,0,0,0,0,0,0,0,0,45,45,45,45,45,45,45,45,45,45,0,0
45,45,45,45,45,45,45,45,45,45,0,0,38,0,0,38,0,0,45,45,45,45,45,45,45,45,45,45,0,0
45,45,45,45,45,45,45,45,45,45,0,0,0,0,0,0,0,0,45,45,45,45,45,45,45,45,45,45,0,0
45,45,45,45,45,45,45,45,45,45,0,0,38,0,0,38,0,0,45,45,45,45,45,45,45,45,45,45,0,0
45,45,45,45,45,45,45,45,45,45,0,0,0,0,0,0,0,0,45,45,45,45,45,45,45,45,45,45,0,0
45,45,45,45,45,45,45,45,45,45,0,0,38,0,0,38,0,0,45,45,45,45,45,45,45,45,45,45,0,0
45,45,45,45,45,45,45,45,45,45,0,0,0,0,0,0,0,0,45,45,45,45,45,45,45,45,45,45,0,0
45,45,45,45,45,45,45,45,45,45,0,0,38,0,0,38,0,0,45,45,45,45,45,45,45,45,45,45,0,0
45,45,45,45,45,45,45,45,45,45,0,0,0,0,0,0,0,0,45,45,45,45,45,45,45,45,45,45,0,0
45,45,45,45,45,45,45,45,45,45,0,0,38,0,0,38,0,0,45,45,45,45,45,45,45,45,45,45,0,0
45,45,45,45,45,45,45,45,45,45,0,0,0,0,0,0,0,0,45,45,45,45,45,45,45,45,45,45,0,0
45,45,45,45,45,45,45,45,45,45,0,0,38,0,0,38,0,0,45,45,45,45,45,45,45,45,45,45,0,0
45,45,45,45,45,45,45,45,45,45,0,0,0,0,0,0,0,0,45,45,45,45,45,45,45,45,45,45,0,0
45,45,45,45,45,45,45,45,45,45,0,0,0,0,0,0,0,0,45,45,45,45,45,45,45,45,45,45,0,0
45,45,45,45,45,45,45,45,45,45,38,39,38,39,38,39,38,39,45,45,45,45,45,45,45,45,45,45,0,0

